5 15
OOOOOOOOOOOOOOO
OOOHHHOOOHHHOOO
OOOOHOOOOOHOOOO
OOOOOOOOOOOOOOO
OOOOOOOOOOOOOOO
